# Any line followed by a '#' character is ignored
# Section headings must be in square brackets
# Subsections within a section should follow the format:
#   [filename within code directory][tab character \t][subsection title]

[Combinatorial optimization]
#stanford/MaxFlow.cc	Dense max-flow
../algorithms/edmondskarp.hpp	Edmonds-Karp max-flow
stanford/Dinic.cc	Dinic max-flow
stanford/MinCostMaxFlow.cc	Min-cost max-flow
stanford/PushRelabel.cc	Push-relabel max-flow
stanford/MinCostMatching.cc	Min-cost matching
stanford/MaxBipartiteMatching.cc	Max bipartite matchine
stanford/MinCut.cc	Global min-cut
stanford/GraphCutInference.cc	Graph cut inference

[Geometry]
stanford/ConvexHull.cc	Convex hull
stanford/Geometry.cc	Miscellaneous geometry
#stanford/Delaunay.cc	Slow Delaunay triangulation

[Numerical algorithms]
stanford/Euclid.cc	Number theory (modular, Chinese remainder, linear Diophantine)
stanford/GaussJordan.cc	Systems of linear equations, matrix inverse, determinant
stanford/ReducedRowEchelonForm.cc	Reduced row echelon form, matrix rank
stanford/FFT_new.cc	Fast Fourier transform
stanford/Simplex.cc	Simplex algorithm
#stanford/FFT.cc	Fast Fourier transform (C++)

[Graph algorithms]
#stanford/BellmanFord.cc	Bellman-Ford shortest paths with negative edge weights (C++)
stanford/Floyd.cc	Floyd's algorithm (C++)
stanford/FastDijkstra.cc	Fast Dijkstra's algorithm
../algorithms/dijkstra.hpp	Dijkstra's algorithm
../algorithms/prim.hpp	Minimum spanning trees using Prim
../algorithms/kruskal.hpp	Minimum spanning trees using Kruskal
stanford/SCC.cc	Strongly connected components
stanford/EulerianPath.cc	Eulerian path
#stanford/Dijkstra.cc	Dijkstra's algorithm
#stanford/Kruskal.cc	Kruskal's algorithm
#stanford/Prim.cc	Minimum spanning trees

[Data structures]
stanford/SuffixArray.cc	Suffix array
stanford/BIT.cc	Binary Indexed Tree
stanford/UnionFind.cc	Union-find set
stanford/KDTree.cc	KD-tree
stanford/splay.cc	Splay tree
stanford/LCA.cc	Lowest common ancestor

[Miscellaneous]
stanford/LongestIncreasingSubsequence.cc	Longest increasing subsequence
stanford/Dates.cc	Dates
stanford/Primes.cc	Prime numbers
stanford/IO.cc	C++ input/output
stanford/KMP.cc	Knuth-Morris-Pratt
stanford/LatLong.cc	Latitude/longitude
vimrc.txt	Vim settings
#stanford/TopologicalSort.cc	Topological sort (C++)
#stanford/RandomSTL.cc	Random STL stuff
#stanford/CSP.cc	Constraint satisfaction problems
#stanford/FastExpo.cc	Fast exponentiation
#stanford/LCS.cc	Longest common subsequence
#stanford/MillerRabin.c	Miller-Rabin Primality Test (C)
